Arizona Cardinals - The Cardinals
Atlanta Falcons - The Falcons
Baltimore Ravens - The Ravens
Buffalo Bills - The Bills
Carolina Panthers - The Panthers
Chicago Bears - The Bears
Cincinnati Bengals - The Bengals
Cleveland Browns - The Browns
Dallas Cowboys - The Cowboys
Denver Broncos - The Broncos
Detroit Lions - The Lions
Green Bay Packers - The Packers
Houston Texans - The Texans
Indianapolis Colts - The Colts
Jacksonville Jaguars - The Jaguars
Kansas City Chiefs - The Chiefs
Las Vegas Raiders - The Raiders
Los Angeles Chargers - The Chargers
Los Angeles Rams - The Rams
Miami Dolphins - The Dolphins
Minnesota Vikings - The Vikings
New England Patriots - The Patriots
New Orleans Saints - The Saints
New York Giants - The Giants
New York Jets - The Jets
Philadelphia Eagles - The Eagles
Pittsburgh Steelers - The Steelers
San Francisco 49ers - The 49ers
Seattle Seahawks - The Seahawks
Tampa Bay Buccaneers - The Buccaneers
Tennessee Titans - The Titans
Washington Football Team - The Football Team